################
#uMMMMMMMMMMMMM#
#M############M#
#M#MMMMMMMMMM#M#
#M#M######MMM#M#
#M#MMMMMM#MMMMM#
#M#M#MMMM#MMM#M#
#M#M######MMM#M#
#M#MMMMMMMMMM#M#
#M############M#
#MMMMMMMMMMMMMM#
################
