################
#NNNNNNNNNNNNNN#
#NNNNNNNNNNNNNN#
#NNNNNNNNNNNNNN#
#NNNNNNNNNNNNNN#
#NNNNNNNNNNNN###
#NNNNNNNNNNNNNd#
#######N########
VVVVVVVNVVVVVVVV